+-+-+-+-+-+-+-+-+-+-+-+*+*+*+*+*+*+*+*+*+*+*+*+*+*+*+*+*+*+*+
|                     |     * *               *             *
+ +-+-+-+-+-+-+ +-+ +-+*+ +*+ +*+ +*+*+ +*+*+*+ + +*+ + + + +
| |         | | |     |   * * * * *   *   *     *   * * * * *
+-+-+-+ +-+ + +-+-+ +-+*+ + + + + + +*+*+*+ +*+*+ +*+*+*+*+*+
* *   * *             | * *   *         *   * * * * * *   * *
+ +*+ +*+*+*+ +*+-+ +-+ + +*+ +*+ +*+ +*+ +*+ + +*+ + + +*+ +
*             *     * * * *     *   * *     * *             *
+*+*+*+*+ +*+*+*+*+ + + + +*+*+ +*+ +*+*+ +*+ + + + +*+ +*+*+
* *       *     *           * *       * *     * * * * * *   *
+ +*+ +*+ +*+*+ +*+*+*+ +*+*+ + +*+*+*+ + +*+*+ +*+*+ +*+*+ +
* * *   * *       *   * *       *       *   *       * * *   *
+ + +*+*+*+*+*+ + +*+ + +*+*+ +*+ +*+*+*+ +*+ +*+*+*+ + +*+ +
*             * *       * *   *       * *               * * *
+ +*+*+*+*+*+ + + +*+ + + +*+ +*+ +*+*+ +*+ +*+*+ + +*+*+ + +
* *           * * *   * *       *   *     *   * * *         *
+*+*+ + +*+ +*+*+*+*+*+ +*+ +*+*+*+ + +*+*+ +*+ + +*+ +*+ +*+
* * * * *     *     *     * * * *   *   *   *   * * * * *   *
+ + +*+*+ +*+*+ + + +*+ + + + + +*+ + +*+ + + +*+ + +*+ +*+*+
* *         * * * * *   * *     * *       * *   *       *   *
+ +*+*+*+*+ + +*+*+ +*+*+ +*+ +*+ + +*+*+ +*+ +*+*+*+*+ + + +
* *       * *     * *         *       * * *     * * * *   * *
+ +*+*+*+ + +*+ +*+ +*+*+*+ + + +*+*+*+ +*+*+ +*+ + + +*+*+ +
*   * *   * *     * * *   * * *   *   * *   *         *   * *
+*+ + +*+ + +*+ +*+ + +*+ + + + +*+*+ + + +*+ + +*+ +*+ +*+*+
* *       *       *   * * * *   *   *   * *   *   * *   * * *
+ +*+*+*+ +*+*+ +*+*+ + + +*+ + + +*+*+ + + +*+*+*+*+ +*+ + +
* *                   *   *   *     * *     *   *           *
+ + +*+*+*+ +*+ +*+*+ +*+ +*+ +*+ +*+ + +*+*+ +*+*+ +*+*+ + +
*   *   * * *     *             *     *   *   *   *     * * *
+*+ +*+ + +*+ +*+*+*+*+*+*+ +*+ + + +*+ +*+ +*+*+ + + +*+*+ +
*   *       * *     *   *     * * *           *     * * * * *
+ +*+*+*+*+ +*+*+*+ +*+ + +*+ +*+*+ + + +*+*+ + + +*+*+ + +*+
* *                         *   * * * *   *     * *   *     *
+*+ + +*+ + + +*+ + + + +*+ + + + + + +*+ + + + +*+ + + +*+ +
*   *   * * * *   * * * *   * *   * * *   * * *     * * * * *
+ + +*+*+ +*+ + +*+ +*+ + +*+ +*+ + +*+*+ + + +*+ + +*+ + + +
* * *   * *   * *   *   *   *   * *     * * *   * *       * *
+ +*+ + +*+ + + +*+ +*+ + +*+ + +*+ +*+*+*+ + +*+*+ +*+*+*+*+
* *   *   * * *   * *   *   * *   * * * *   * *     *       *
+ +*+ +*+ + +*+ +*+ +*+ + + +*+ + + + + +*+ + + +*+ + + + +*+
*   * *   * * * *     * * * *   * *   * *   * * *     * *   *
+ + + + + + + +*+*+*+*+ + +*+ +*+ + + + + + +*+ +*+ + + + + +
* * * * *       *       * *   *   * *   * *   *   * * * * * *
+ + + +*+ +*+ +*+*+*+*+*+ +*+ +*+ + + +*+ +*+ +*+*+ +*+*+*+ +
* * * *   *     * * * *   *     * * *   *   *   *         * *
+ +*+*+*+ + + +*+ + + + +*+*+ +*+ +*+ +*+*+*+ + +*+*+ +*+ +*+
*     * * * * *           *   *     *     *   *     *   *   *
+ +*+*+ +*+*+*+*+*+ + + +*+*+ +*+ +*+ + +*+*+ + + +*+ + +*+*+
* *         *   *   * * *       * *   *     * * * *   *     *
+*+*+ + +*+ +*+ +*+ + + +*+*+ + + + + +*+ + +*+ + + + + +*+*+
*     *   *         * * *     * * * *   * *   * * * * *     *
+*+ +*+ +*+ + +*+ + + + + + + +*+ +*+*+ +*+*+*+*+ + +*+*+*+ +
*     * *   * *   * * * * * * *     * *   *   *   *       * *
+ + +*+*+*+ +*+ + + +*+ +*+*+ + +*+*+ +*+*+ + +*+ + + +*+*+ +
* *   *     *   * *   *   *   *             *   * * *   *   *
+ +*+*+ + +*+ +*+ +*+*+ + + +*+ +*+ + + +*+*+*+*+*+ + +*+ +*+
*   *   * *   *   *     * * *   * * * * * * * *     *   *   *
+ +*+ +*+ + +*+*+*+*+ +*+*+ +*+ + +*+*+ + + + +*+ + +*+*+*+ +
*   * *   * *           *   *         *       *   *       * *
+*+*+*+*+*+*+*+*+*+*+*+*+*+*+*+*+*+*+*+*+*+*+*+*+*+*+*+*+*+*+
