+-+-+-+-+-+-+-+-+-+-+-+-+-+-+-+-+-+-+-+-+-+-+-+-+-+-+-+-+-+-+
|                     |     | |               |             |
+ +-+-+-+-+-+-+ +-+ +-+-+ +-+ +-+ +-+-+ +-+-+-+ + +-+ + + + +
| |         | | |     |   | | | | |   |   |     |   | | | | |
+-+-+-+ +-+ + +-+-+ +-+-+ + + + + + +-+-+-+ +-+-+ +-+-+-+-+-+
| |   | |             | | |   |         |   | | | | | |   | |
+ +-+ +-+-+-+ +-+-+ +-+ + +-+ +-+ +-+ +-+ +-+ + +-+ + + +-+ +
|             |     | | | |     |   | |     | |             |
+-+-+-+-+ +-+-+-+-+ + + + +-+-+ +-+ +-+-+ +-+ + + + +-+ +-+-+
| |       |     |           | |       | |     | | | | | |   |
+ +-+ +-+ +-+-+ +-+-+-+ +-+-+ + +-+-+-+ + +-+-+ +-+-+ +-+-+ +
| | |   | |       |   | |       |       |   |       | | |   |
+ + +-+-+-+-+-+ + +-+ + +-+-+ +-+ +-+-+-+ +-+ +-+-+-+ + +-+ +
|             | |       | |   |       | |               | | |
+ +-+-+-+-+-+ + + +-+ + + +-+ +-+ +-+-+ +-+ +-+-+ + +-+-+ + +
| |           | | |   | |       |   |     |   | | |         |
+-+-+ + +-+ +-+-+-+-+-+ +-+ +-+-+-+ + +-+-+ +-+ + +-+ +-+ +-+
| | | | |     |     |     | | | |   |   |   |   | | | | |   |
+ + +-+-+ +-+-+ + + +-+ + + + + +-+ + +-+ + + +-+ + +-+ +-+-+
| |         | | | | |   | |     | |       | |   |       |   |
+ +-+-+-+-+ + +-+-+ +-+-+ +-+ +-+ + +-+-+ +-+ +-+-+-+-+ + + +
| |       | |     | |         |       | | |     | | | |   | |
+ +-+-+-+ + +-+ +-+ +-+-+-+ + + +-+-+-+ +-+-+ +-+ + + +-+-+ +
|   | |   | |     | | |   | | |   |   | |   |         |   | |
+-+ + +-+ + +-+ +-+ + +-+ + + + +-+-+ + + +-+ + +-+ +-+ +-+-+
| |       |       |   | | | |   |   |   | |   |   | |   | | |
+ +-+-+-+ +-+-+ +-+-+ + + +-+ + + +-+-+ + + +-+-+-+-+ +-+ + +
| |                   |   |   |     | |     |   |           |
+ + +-+-+-+ +-+ +-+-+ +-+ +-+ +-+ +-+ + +-+-+ +-+-+ +-+-+ + +
|   |   | | |     |             |     |   |   |   |     | | |
+-+ +-+ + +-+ +-+-+-+-+-+-+ +-+ + + +-+ +-+ +-+-+ + + +-+-+ +
|   |       | |     |   |     | | |           |     | | | | |
+ +-+-+-+-+ +-+-+-+ +-+ + +-+ +-+-+ + + +-+-+ + + +-+-+ + +-+
| |                         |   | | | |   |     | |   |     |
+-+ + +-+ + + +-+ + + + +-+ + + + + + +-+ + + + +-+ + + +-+ +
|   |   | | | |   | | | |   | |   | | |   | | |     | | | | |
+ + +-+-+ +-+ + +-+ +-+ + +-+ +-+ + +-+-+ + + +-+ + +-+ + + +
| | |   | |   | |   |   |   |   | |     | | |   | |       | |
+ +-+ + +-+ + + +-+ +-+ + +-+ + +-+ +-+-+-+ + +-+-+ +-+-+-+-+
| |   |   | | |   | |   |   | |   | | | |   | |     |       |
+ +-+ +-+ + +-+ +-+ +-+ + + +-+ + + + + +-+ + + +-+ + + + +-+
|   | |   | | | |     | | | |   | |   | |   | | |     | |   |
+ + + + + + + +-+-+-+-+ + +-+ +-+ + + + + + +-+ +-+ + + + + +
| | | | |       |       | |   |   | |   | |   |   | | | | | |
+ + + +-+ +-+ +-+-+-+-+-+ +-+ +-+ + + +-+ +-+ +-+-+ +-+-+-+ +
| | | |   |     | | | |   |     | | |   |   |   |         | |
+ +-+-+-+ + + +-+ + + + +-+-+ +-+ +-+ +-+-+-+ + +-+-+ +-+ +-+
|     | | | | |           |   |     |     |   |     |   |   |
+ +-+-+ +-+-+-+-+-+ + + +-+-+ +-+ +-+ + +-+-+ + + +-+ + +-+-+
| |         |   |   | | |       | |   |     | | | |   |     |
+-+-+ + +-+ +-+ +-+ + + +-+-+ + + + + +-+ + +-+ + + + + +-+-+
|     |   |         | | |     | | | |   | |   | | | | |     |
+-+ +-+ +-+ + +-+ + + + + + + +-+ +-+-+ +-+-+-+-+ + +-+-+-+ +
|     | |   | |   | | | | | | |     | |   |   |   |       | |
+ + +-+-+-+ +-+ + + +-+ +-+-+ + +-+-+ +-+-+ + +-+ + + +-+-+ +
| |   |     |   | |   |   |   |             |   | | |   |   |
+ +-+-+ + +-+ +-+ +-+-+ + + +-+ +-+ + + +-+-+-+-+-+ + +-+ +-+
|   |   | |   |   |     | | |   | | | | | | | |     |   |   |
+ +-+ +-+ + +-+-+-+-+ +-+-+ +-+ + +-+-+ + + + +-+ + +-+-+-+ +
|   | |   | |           |   |         |       |   |       | |
+-+-+-+-+-+-+-+-+-+-+-+-+-+-+-+-+-+-+-+-+-+-+-+-+-+-+-+-+-+-+
